17 10
##########
#S       #
#        #
#        #
#        #
#        #
#        #
#        #
#        #
#        #
#        #
#        #
#        #
#        #
#        #
#        #
##########